OOOOOOOYSOO
OSSSSSSRSSO
OSRYYYSRYSO
OSRSSRSSRSO
OSRSOOOSRSO
OSRSOOOSRSO
OSRSOOOSRSO
OSRSSRSSRSO
OSYRSYYYRSO
OSSRSSSSSSO
OOSYOOOOOOO